//MAP CONVERTED BY dmm2tgm.py THIS HEADER COMMENT PREVENTS RECONVERSION, DO NOT REMOVE
"a" = (
/obj/effect/turf_decal/stripes/line{
	dir = 8
	},
/obj/effect/turf_decal/siding/dark{
	dir = 8
	},
/turf/open/floor/iron/dark/smooth_edge{
	dir = 4
	},
/area/station/common/night_club/back_stage)
"b" = (
/obj/structure/railing,
/turf/open/floor/iron/stairs/medium{
	dir = 4
	},
/area/station/common/night_club/back_stage)
"c" = (
/obj/machinery/door/airlock/maintenance,
/obj/effect/mapping_helpers/airlock/access/all/security/general,
/turf/open/floor/catwalk_floor/iron_smooth,
/area/station/common/night_club/back_stage)
"d" = (
/obj/structure/cable,
/obj/machinery/atmospherics/pipe/smart/manifold4w/supply/hidden/layer4,
/obj/machinery/atmospherics/pipe/smart/manifold4w/scrubbers/hidden/layer2,
/obj/effect/turf_decal/siding/dark{
	dir = 8
	},
/obj/effect/turf_decal/siding/dark{
	dir = 4
	},
/turf/open/floor/iron/dark/small,
/area/station/common/night_club/back_stage)
"e" = (
/obj/effect/turf_decal/stripes/corner{
	dir = 1
	},
/obj/effect/turf_decal/siding/dark/corner{
	dir = 1
	},
/turf/open/floor/iron/dark/textured_corner{
	dir = 1
	},
/area/station/common/night_club/back_stage)
"f" = (
/obj/structure/chair/comfy/black{
	dir = 4
	},
/obj/effect/turf_decal/siding/dark{
	dir = 1
	},
/turf/open/floor/carpet/donk,
/area/station/common/night_club/back_stage)
"h" = (
/obj/effect/turf_decal/siding/dark{
	dir = 4
	},
/obj/machinery/atmospherics/pipe/smart/manifold4w/scrubbers/hidden/layer2,
/obj/effect/landmark/event_spawn,
/obj/effect/turf_decal/siding/dark{
	dir = 8
	},
/obj/structure/railing/corner{
	dir = 4
	},
/turf/open/floor/iron/dark/small,
/area/station/common/night_club/back_stage)
"i" = (
/turf/template_noop,
/area/template_noop)
"j" = (
/obj/machinery/camera/directional/south{
	c_tag = "Service - Nightclub Backroom"
	},
/obj/structure/chair/comfy/black{
	dir = 8
	},
/obj/effect/turf_decal/siding/dark{
	dir = 1
	},
/obj/machinery/firealarm/directional/south,
/turf/open/floor/carpet/donk,
/area/station/common/night_club/back_stage)
"k" = (
/obj/machinery/atmospherics/components/unary/vent_scrubber/on/layer2{
	dir = 1
	},
/obj/effect/turf_decal/siding/dark{
	dir = 8
	},
/obj/effect/turf_decal/siding/dark{
	dir = 4
	},
/turf/open/floor/iron/dark/small,
/area/station/common/night_club/back_stage)
"n" = (
/obj/effect/turf_decal/siding/dark{
	dir = 8
	},
/obj/effect/turf_decal/siding/dark{
	dir = 4
	},
/turf/open/floor/iron/dark/small,
/area/station/common/night_club/back_stage)
"o" = (
/obj/machinery/atmospherics/pipe/smart/manifold4w/scrubbers/hidden/layer2,
/obj/machinery/atmospherics/components/unary/vent_pump/on/layer4{
	dir = 1
	},
/obj/effect/turf_decal/siding/dark{
	dir = 8
	},
/obj/effect/turf_decal/siding/dark{
	dir = 4
	},
/turf/open/floor/iron/dark/small,
/area/station/common/night_club/back_stage)
"p" = (
/obj/structure/window/reinforced/tinted/spawner/directional/west,
/obj/structure/window/reinforced/tinted/spawner/directional/east,
/obj/structure/window/reinforced/tinted/spawner/directional/south,
/obj/structure/window/reinforced/tinted/spawner/directional/north,
/obj/structure/flora/bush/large/style_3,
/obj/structure/flora/bush/fullgrass,
/obj/structure/flora/bush/flowers_br,
/obj/structure/flora/bush/flowers_pp,
/obj/structure/flora/bush/style_random,
/turf/open/floor/grass,
/area/station/common/night_club/back_stage)
"q" = (
/obj/effect/turf_decal/siding/dark,
/obj/machinery/smartfridge/drying/rack,
/obj/item/food/grown/cannabis{
	pixel_x = -5
	},
/obj/item/food/grown/cannabis,
/turf/open/floor/iron/dark/smooth_large,
/area/station/common/night_club/back_stage)
"r" = (
/obj/machinery/airalarm/directional/north,
/obj/structure/chair/office{
	dir = 8
	},
/obj/effect/landmark/start/bouncer,
/turf/open/floor/iron/dark/smooth_large,
/area/station/common/night_club/back_stage)
"s" = (
/obj/effect/turf_decal/siding/dark{
	dir = 8
	},
/obj/machinery/door/airlock/security/blue{
	name = "Service Security Outpost"
	},
/obj/effect/mapping_helpers/airlock/access/all/security/general,
/turf/open/floor/iron/dark/herringbone,
/area/station/common/night_club/back_stage)
"t" = (
/obj/machinery/computer/security/wooden_tv{
	pixel_x = 3;
	pixel_y = 2
	},
/obj/structure/table/wood,
/obj/item/reagent_containers/cup/soda_cans/nova/ginger_beer{
	pixel_x = -11;
	pixel_y = 3
	},
/turf/open/floor/iron/dark/smooth_large,
/area/station/common/night_club/back_stage)
"u" = (
/obj/machinery/light/directional/west,
/obj/structure/window/reinforced/tinted/spawner/directional/south,
/obj/machinery/computer/records/security{
	dir = 4
	},
/turf/open/floor/iron/dark/smooth_large,
/area/station/common/night_club/back_stage)
"w" = (
/obj/effect/turf_decal/stripes/line{
	dir = 1
	},
/obj/effect/turf_decal/siding/dark{
	dir = 1
	},
/turf/open/floor/iron/dark/smooth_edge,
/area/station/common/night_club/back_stage)
"x" = (
/obj/structure/closet/secure_closet/security/service,
/turf/open/floor/iron/dark/smooth_large,
/area/station/common/night_club/back_stage)
"A" = (
/obj/machinery/door/airlock/maintenance,
/obj/structure/cable,
/obj/machinery/atmospherics/pipe/smart/manifold4w/supply/hidden/layer4,
/obj/machinery/atmospherics/pipe/smart/manifold4w/scrubbers/hidden/layer2,
/obj/effect/mapping_helpers/airlock/access/all/security/general,
/turf/open/floor/catwalk_floor/iron_smooth,
/area/station/common/night_club/back_stage)
"C" = (
/turf/open/floor/iron/dark/smooth_large,
/area/station/common/night_club/back_stage)
"D" = (
/obj/machinery/power/apc/auto_name/directional/north,
/obj/structure/cable,
/obj/effect/turf_decal/stripes/line{
	dir = 8
	},
/obj/effect/turf_decal/siding/dark{
	dir = 8
	},
/turf/open/floor/iron/dark/smooth_edge{
	dir = 4
	},
/area/station/common/night_club/back_stage)
"E" = (
/obj/structure/window/reinforced/tinted/spawner/directional/south,
/turf/open/floor/iron/dark/smooth_large,
/area/station/common/night_club/back_stage)
"G" = (
/obj/item/radio/intercom/directional/west,
/obj/effect/turf_decal/stripes/line{
	dir = 1
	},
/obj/effect/turf_decal/siding/dark{
	dir = 1
	},
/turf/open/floor/iron/dark/smooth_edge,
/area/station/common/night_club/back_stage)
"K" = (
/obj/machinery/newscaster/directional/west,
/obj/structure/table/wood,
/obj/item/storage/cans/sixbeer,
/turf/open/floor/iron/dark/smooth_large,
/area/station/common/night_club/back_stage)
"M" = (
/obj/structure/toiletbong,
/turf/open/floor/iron/dark/smooth_large,
/area/station/common/night_club/back_stage)
"N" = (
/obj/structure/railing{
	dir = 1
	},
/turf/open/floor/iron/stairs/medium{
	dir = 4
	},
/area/station/common/night_club/back_stage)
"P" = (
/obj/machinery/vending/boozeomat,
/obj/effect/turf_decal/siding/dark{
	dir = 1
	},
/obj/machinery/light/directional/east,
/turf/open/floor/iron/dark/smooth_large,
/area/station/common/night_club/back_stage)
"Q" = (
/obj/structure/window/reinforced/tinted/spawner/directional/west,
/obj/structure/window/reinforced/tinted/spawner/directional/east,
/obj/structure/window/reinforced/tinted/spawner/directional/south,
/obj/structure/window/reinforced/tinted/spawner/directional/north,
/obj/structure/flora/bush/large/style_3,
/obj/structure/flora/bush/fullgrass,
/obj/structure/flora/bush/flowers_br,
/obj/structure/flora/bush/flowers_yw,
/obj/structure/flora/bush/style_random,
/turf/open/floor/grass,
/area/station/common/night_club/back_stage)
"R" = (
/obj/effect/turf_decal/siding/dark{
	dir = 8
	},
/obj/effect/mapping_helpers/airlock/access/all/security/general,
/obj/machinery/door/airlock/security/blue{
	name = "Service Security Outpost"
	},
/turf/open/floor/iron/dark/herringbone,
/area/station/common/night_club/back_stage)
"S" = (
/obj/effect/turf_decal/siding/dark{
	dir = 1
	},
/obj/structure/table/reinforced/plastitaniumglass,
/obj/item/bong/lungbuster{
	pixel_y = 10;
	pixel_x = -2
	},
/obj/item/reagent_containers/hash/dabs{
	pixel_x = -2
	},
/obj/item/reagent_containers/hash/dabs{
	pixel_x = 7
	},
/obj/item/reagent_containers/hash/dabs{
	pixel_x = 9;
	pixel_y = 8
	},
/turf/open/floor/carpet/donk,
/area/station/common/night_club/back_stage)
"W" = (
/turf/closed/wall,
/area/station/common/night_club/back_stage)
"X" = (
/obj/effect/turf_decal/siding/dark{
	dir = 4
	},
/obj/machinery/holopad,
/obj/machinery/atmospherics/pipe/smart/manifold4w/scrubbers/hidden/layer2,
/obj/effect/turf_decal/siding/dark{
	dir = 8
	},
/obj/structure/railing/corner,
/turf/open/floor/iron/dark/small,
/area/station/common/night_club/back_stage)

(1,1,1) = {"
W
W
W
W
W
W
W
i
"}
(2,1,1) = {"
W
t
K
u
G
f
W
i
"}
(3,1,1) = {"
W
r
C
E
w
S
W
i
"}
(4,1,1) = {"
W
D
a
a
e
j
W
W
"}
(5,1,1) = {"
A
d
o
h
X
k
n
c
"}
(6,1,1) = {"
W
M
q
N
b
P
x
W
"}
(7,1,1) = {"
W
Q
W
s
R
W
p
W
"}
